Old Town Road - Lil Nas X Featuring Billy Ray Cyrus
7 Rings - Ariana Grande
Bad Guy - Billie Eilish
Wow. - Post Malone
Sucker - Jonas Brothers
Talk - Khalid
Senorita - Shawn Mendes & Camila Cabello
I Don't Care - Ed Sheeran & Justin Bieber
Dancing With A Stranger - Sam Smith & Normani
Middle Child - J. Cole
Truth Hurts - Lizzo
Please Me - Cardi B & Bruno Mars
If I Can't Have You - Shawn Mendes
Break Up With Your Girlfriend, I'm Bored - Ariana Grande
ME! - Taylor Swift Featuring Brendon Urie
Suge - DaBaby
No Guidance - Chris Brown Featuring Drake
Thotiana - Blueface
You Need To Calm Down - Taylor Swift
Goodbyes - Post Malone Featuring Young Thug
A Lot - 21 Savage
Money In The Grave - Drake Featuring Rick Ross
God's Country - Blake Shelton
Pop Out - Polo G Featuring Lil Tjay
Ran$om - Lil Tecca
Whiskey Glasses - Morgan Wallen
Pure Water - Mustard & Migos
Hey Look Ma, I Made It - Panic! At The Disco
Murder On My Mind - YNW Melly
Con Calma - Daddy Yankee & Katy Perry Featuring Snow
Act Up - City Girls
Beer Never Broke My Heart - Luke Combs
The Git Up - Blanco Brown
The London - Young Thug, J. Cole & Travis Scott
Bury A Friend - Billie Eilish
Someone You Loved - Lewis Capaldi
Baby Shark - Pinkfong
Rumor - Lee Brice
Worth It - YK Osiris
Swervin - A Boogie Wit da Hoodie Featuring 6ix9ine
Never Really Over - Katy Perry
Look What God Gave Her - Thomas Rhett
Good As You - Kane Brown
Clout - Offset Featuring Cardi B
Earfquake - Tyler, The Creator
Robbery - Juice WRLD
Beautiful People - Ed Sheeran Featuring Khalid
Eyes On You - Chase Rice
Tequila - Dan + Shay
Knockin' Boots - Luke Bryan
Shotta Flow - NLE Choppa
Panini - Lil Nas X
Talk You Out Of It - Florida Georgia Line
Walk Me Home - P!nk
Here With Me - Marshmello Featuring CHVRCHES
GIRL - Maren Morris
Here Tonight - Brett Young
Homicide - Logic Featuring Eminem
Miss Me More - Kelsea Ballerini
Girls Need Love - Summer Walker X Drake
Put A Date On It - Yo Gotti Featuring Lil Baby
Mixed Personalities - YNW Melly Featuring Kanye West
All To Myself - Dan + Shay
Cool - Jonas Brothers
Go Loko - YG, Tyga & Jon Z
Nightmare - Halsey
Who Do You Love - The Chainsmokers Featuring 5 Seconds Of Summer
Sanguine Paradise - Lil Uzi Vert
Press - Cardi B
Make It Sweet - Old Dominion
Boy With Luv - BTS Featuring Halsey
Twerk - City Girls Featuring Cardi B
Cross Me - Ed Sheeran Featuring Chance The Rapper & PnB Rock
Love Ain't - Eli Young Band
Calma - Pedro Capo X Farruko
Just Us - DJ Khaled Featuring SZA
Boyfriend - Ariana Grande & Social House
Rearview Town - Jason Aldean
Easier - 5 Seconds Of Summer
Racks In The Middle - Nipsey Hussle Featuring Roddy Ricch & Hit-Boy
Before I Let Go - Beyonce
Shot Clock - Ella Mai
Undecided - Chris Brown
Some Of It - Eric Church
Take It From Me - Jordan Davis
Night Shift - Jon Pardi
Soltera - Lunay, Daddy Yankee & Bad Bunny
Ocean Eyes - Billie Eilish
My Type - Saweetie
Trampoline - SHAED
Callaita - Bad Bunny & Tainy
Otro Trago - Sech, Darell, Nicky Jam, Ozuna & Anuel AA
Call You Mine - The Chainsmokers & Bebe Rexha
On My Way To You - Cody Johnson
Cash Shit - Megan Thee Stallion Featuring DaBaby
Down To The Honkytonk - Jake Owen
Wish You Were Gay - Billie Eilish
Raised On Country - Chris Young
What Makes You Country - Luke Bryan
Wish Wish - DJ Khaled Featuring Cardi B & 21 Savage
