Rolling In The Deep - Adele
Love The Way You Lie - Eminem Featuring Rihanna
California Gurls - Katy Perry Featuring Snoop Dogg
E.T. - Katy Perry Featuring Kanye West
Firework - Katy Perry
Just The Way You Are - Bruno Mars
Grenade - Bruno Mars
OMG - Usher Featuring will.i.am
Rude Boy - Rihanna
Like A G6 - Far*East Movement Featuring Cataracs & Dev
Nothin' On You - B.o.B Featuring Bruno Mars
Dynamite - Taio Cruz
Teenage Dream - Katy Perry
Last Friday Night (T.G.I.F.) - Katy Perry
Airplanes - B.o.B Featuring Hayley Williams
F**k You! (Forget You) - Cee Lo Green
S&M - Rihanna Featuring Britney Spears
Break Your Heart - Taio Cruz Featuring Ludacris
Only Girl (In The World) - Rihanna
Raise Your Glass - P!nk
What's My Name? - Rihanna Featuring Drake
We R Who We R - Ke$ha
DJ Got Us Fallin' In Love - Usher Featuring Pitbull
Just A Dream - Nelly
I Like It - Enrique Iglesias Featuring Pitbull
Black And Yellow - Wiz Khalifa
Not Afraid - Eminem
Billionaire - Travie McCoy Featuring Bruno Mars
Tonight (I'm Lovin' You) - Enrique Iglesias Featuring Ludacris & DJ Frank E
Cooler Than Me - Mike Posner
The Lazy Song - Bruno Mars
Your Love Is My Drug - Ke$ha
Down On Me - Jeremih Featuring 50 Cent
Bottoms Up - Trey Songz Featuring Nicki Minaj
If I Die Young - The Band Perry
Alejandro - Lady Gaga
The Time (Dirty Bit) - The Black Eyed Peas
Mine - Taylor Swift
Find Your Love - Drake
Club Can't Handle Me - Flo Rida Featuring David Guetta
The Show Goes On - Lupe Fiasco
Blow - Ke$ha
Ridin' Solo - Jason Derulo
Hey Baby (Drop It To The Floor) - Pitbull Featuring T-Pain
Baby - Justin Bieber Featuring Ludacris
Animal - Neon Trees
No Hands - Waka Flocka Flame Featuring Roscoe Dash & Wale
Bulletproof - La Roux
Coming Home - Diddy - Dirty Money Featuring Skylar Grey
Take It Off - Ke$ha
Blah Blah Blah - Ke$ha Featuring 3OH!3
Secrets - OneRepublic
Whataya Want From Me - Adam Lambert
Deuces - Chris Brown Featuring Tyga & Kevin McCall
Right Above It - Lil Wayne Featuring Drake
Yeah 3X - Chris Brown
Jar Of Hearts - Christina Perri
My Chick Bad - Ludacris Featuring Nicki Minaj
Today Was A Fairytale - Taylor Swift
Stereo Love - Edward Maya & Vika Jigulina
Rocketeer - Far*East Movement Featuring Ryan Tedder
Magic - B.o.B Featuring Rivers Cuomo
Stuck Like Glue - Sugarland
Misery - Maroon 5
Over - Drake
Back To December - Taylor Swift
Please Don't Go - Mike Posner
Your Love - Nicki Minaj
More - Usher
All Of The Lights - Kanye West
Impossible - Shontelle
My First Kiss - 3OH!3 Featuring Ke$ha
Rock That Body - The Black Eyed Peas
We Are The World 25: For Haiti - Artists For Haiti
Don't You Wanna Stay - Jason Aldean With Kelly Clarkson
Pretty Girl Rock - Keri Hilson
Un-Thinkable (I'm Ready) - Alicia Keys
Whip My Hair - WILLOW
I Made It (Cash Money Heroes) - Kevin Rudolf Featuring Birdman, Jay Sean, & Lil Wayne
All I Do Is Win - DJ Khaled Featuring T-Pain, Ludacris, Snoop Dogg & Rick Ross
There Goes My Baby - Usher
Hey Daddy (Daddy's Home) - Usher Featuring Plies
Say Something - Timbaland Featuring Drake
Eenie Meenie - Sean Kingston & Justin Bieber
Naturally - Selena Gomez & The Scene
Mean - Taylor Swift
Love Like Woe - The Ready Set
Fly - Nicki Minaj Featuring Rihanna
The Only Exception - Paramore
The House That Built Me - Miranda Lambert
Hot Tottie - Usher Featuring Jay-Z
King Of Anything - Sara Bareilles
Never Say Never - Justin Bieber Featuring Jaden Smith
American Honey - Lady Antebellum
The Boys of Fall - Kenny Chesney
No Love - Eminem Featuring Lil Wayne
Can't Be Tamed - Miley Cyrus
Teach Me How To Dougie - Cali Swag District
Aston Martin Music - Rick Ross Featuring Drake & Chrisette Michele
Somewhere With You - Kenny Chesney
