Blurred Lines - Robin Thicke Featuring T.I. + Pharrell
Royals - Lorde
Dark Horse - Katy Perry Featuring Juicy J
All Of Me - John Legend
Can't Hold Us - Macklemore & Ryan Lewis Featuring Ray Dalton
Roar - Katy Perry
The Monster - Eminem Featuring Rihanna
Timber - Pitbull Featuring Ke$ha
Wrecking Ball - Miley Cyrus
Just Give Me A Reason - P!nk Featuring Nate Ruess
Counting Stars - OneRepublic
Harlem Shake - Baauer
Get Lucky - Daft Punk Featuring Pharrell Williams
Wake Me Up! - Avicii
We Can't Stop - Miley Cyrus
Mirrors - Justin Timberlake
Stay - Rihanna Featuring Mikky Ekko
Pompeii - Bastille
Say Something - A Great Big World & Christina Aguilera
Holy Grail - Jay Z Featuring Justin Timberlake
Demons - Imagine Dragons
Hold On, We're Going Home - Drake Featuring Majid Jordan
Let Her Go - Passenger
Suit & Tie - Justin Timberlake Featuring JAY Z
Team - Lorde
Let It Go - Idina Menzel
Applause - Lady Gaga
Story Of My Life - One Direction
Safe And Sound - Capital Cities
Treasure - Bruno Mars
Cups (Pitch Perfect's When I'm Gone) - Anna Kendrick
Started From The Bottom - Drake
Come & Get It - Selena Gomez
I Love It - Icona Pop Featuring Charli XCX
Clarity - Zedd Featuring Foxes
The Way - Ariana Grande Featuring Mac Miller
Best Day Of My Life - American Authors
Burn - Ellie Goulding
Summertime Sadness - Lana Del Rey & Cedric Gervais
Feel This Moment - Pitbull Featuring Christina Aguilera
The Man - Aloe Blacc
Love Me - Lil Wayne Featuring Drake & Future
Show Me - Kid Ink Featuring Chris Brown
Berzerk - Eminem
Same Love - Macklemore & Ryan Lewis Featuring Mary Lambert
23 - Mike WiLL Made-It Featuring Miley Cyrus, Wiz Khalifa & Juicy J
Heart Attack - Demi Lovato
My Songs Know What You Did In The Dark (Light Em Up) - Fall Out Boy
Love Somebody - Maroon 5
My Hitta - YG Featuring Jeezy & Rich Homie Quan
Sweater Weather - The Neighbourhood
Best Song Ever - One Direction
Brave - Sara Bareilles
The Fox - Ylvis
Power Trip - J. Cole Featuring Miguel
This Is How We Roll - Florida Georgia Line Featuring Luke Bryan
Wagon Wheel - Darius Rucker
Boys 'round Here - Blake Shelton Featuring Pistol Annies & Friends
That's My Kind Of Night - Luke Bryan
I Need Your Love - Calvin Harris Featuring Ellie Goulding
Hey Brother - Avicii
Animals - Martin Garrix
Bad - Wale Featuring Tiara Thomas Or Rihanna
Do What U Want - Lady Gaga Featuring R. Kelly
Gone, Gone, Gone - Phillip Phillips
The Other Side - Jason Derulo
Love More - Chris Brown Featuring Nicki Minaj
Stay The Night - Zedd Featuring Hayley Williams
White Walls - Macklemore & Ryan Lewis Featuring ScHoolboy Q & Hollis
Unconditionally - Katy Perry
Rap God - Eminem
Crash My Party - Luke Bryan
#Beautiful - Mariah Carey Featuring Miguel
Pour It Up - Rihanna
Gas Pedal - Sage The Gemini Featuring IamSu!
I Want Crazy - Hunter Hayes
Carry On - fun.
Highway Don't Care - Tim McGraw With Taylor Swift
Still Into You - Paramore
It Goes Like This - Thomas Rhett
Body Party - Ciara
Gentleman - PSY
Sure Be Cool If You Did - Blake Shelton
U.O.E.N.O. - Rocko Featuring Future & Rick Ross
Adore You - Miley Cyrus
#thatPOWER - will.i.am Featuring Justin Bieber
Troublemaker - Olly Murs Featuring Flo Rida
All Me - Drake Featuring 2 Chainz & Big Sean
Mama's Broken Heart - Miranda Lambert
Drink A Beer - Luke Bryan
Crooked Smile - J. Cole Featuring TLC
Runnin' Outta Moonlight - Randy Houser
Stay - Florida Georgia Line
Next To Me - Emeli Sande
Slow Down - Selena Gomez
Round Here - Florida Georgia Line
Redneck Crazy - Tyler Farr
Get Your Shine On - Florida Georgia Line
Really Don't Care - Demi Lovato Featuring Cher Lloyd
Downtown - Lady Antebellum
