Despacito - Luis Fonsi & Daddy Yankee Featuring Justin Bieber
Shape Of You - Ed Sheeran
Rockstar - Post Malone Featuring 21 Savage
Perfect - Ed Sheeran
Bodak Yellow (Money Moves) - Cardi B
Havana - Camila Cabello Featuring Young Thug
I'm The One - DJ Khaled Featuring Justin Bieber, Quavo, Chance The Rapper & Lil Wayne
Meant To Be - Bebe Rexha & Florida Georgia Line
Humble. - Kendrick Lamar
Wild Thoughts - DJ Khaled Featuring Rihanna & Bryson Tiller
Look What You Made Me Do - Taylor Swift
Thunder - Imagine Dragons
Believer - Imagine Dragons
Unforgettable - French Montana Featuring Swae Lee
1-800-273-8255 - Logic Featuring Alessia Cara & Khalid
Something Just Like This - The Chainsmokers & Coldplay
Feel It Still - Portugal. The Man
Body Like A Back Road - Sam Hunt
Mask Off - Future
Attention - Charlie Puth
Too Good At Goodbyes - Sam Smith
Gucci Gang - Lil Pump
New Rules - Dua Lipa
XO TOUR Llif3 - Lil Uzi Vert
There's Nothing Holdin' Me Back - Shawn Mendes
Stay - Zedd & Alessia Cara
Sorry Not Sorry - Demi Lovato
iSpy - KYLE Featuring Lil Yachty
Bad At Love - Halsey
No Limit - G-Eazy Featuring A$AP Rocky & Cardi B
Mi Gente - J Balvin & Willy William Featuring Beyonce
Never Be The Same - Camila Cabello
It Ain't Me - Kygo x Selena Gomez
Paris - The Chainsmokers
Bank Account - 21 Savage
MotorSport - Migos, Nicki Minaj & Cardi B
Issues - Julia Michaels
Location - Khalid
Slow Hands - Niall Horan
Strip That Down - Liam Payne Featuring Quavo
Love. - Kendrick Lamar Featuring Zacari
Tunnel Vision - Kodak Black
Let You Down - NF
What Lovers Do - Maroon 5 Featuring SZA
Rake It Up - Yo Gotti Featuring Nicki Minaj
I Get The Bag - Gucci Mane Featuring Migos
I Fall Apart - Post Malone
Young Dumb & Broke - Khalid
Castle On The Hill - Ed Sheeran
Whatever It Takes - Imagine Dragons
Him & I - G-Eazy & Halsey
DNA. - Kendrick Lamar
Chained To The Rhythm - Katy Perry Featuring Skip Marley
Ric Flair Drip - Offset & Metro Boomin
Gummo - 6ix9ine
T-Shirt - Migos
Passionfruit - Drake
Heaven - Kane Brown
Now Or Never - Halsey
Wolves - Selena Gomez X Marshmello
How Long - Charlie Puth
What About Us - P!nk
...Ready For It? - Taylor Swift
Praying - Kesha
In Case You Didn't Know - Brett Young
Sign Of The Times - Harry Styles
Rolex - Ayo & Teo
Wait - Maroon 5
Lights Down Low - MAX Featuring gnash
Cold - Maroon 5 Featuring Future
Swang - Rae Sremmurd
Loyalty. - Kendrick Lamar Featuring Rihanna
Feels - Calvin Harris Featuring Pharrell Williams, Katy Perry & Big Sean
Plain Jane - A$AP Ferg Featuring Nicki Minaj
Sky Walker - Miguel Featuring Travis Scott
Malibu - Miley Cyrus
What Ifs - Kane Brown Featuring Lauren Alaina
Slide - Calvin Harris Featuring Frank Ocean & Migos
The Way Life Goes - Lil Uzi Vert Featuring Nicki Minaj
The Weekend - SZA
Magnolia - Playboi Carti
Roll In Peace - Kodak Black Featuring XXXTENTACION
Silence - Marshmello Featuring Khalid
Down - Marian Hill
Slippery - Migos Featuring Gucci Mane
Love Galore - SZA Featuring Travis Scott
Marry Me - Thomas Rhett
Both - Gucci Mane Featuring Drake
Hurricane - Luke Combs
Do Re Mi - blackbear
Drowning - A Boogie Wit da Hoodie Featuring Kodak Black
Swalla - Jason Derulo Featuring Nicki Minaj & Ty Dolla $ign
Everyday We Lit - YFN Lucci Featuring PnB Rock
Small Town Boy - Dustin Lynch
No Promises - Cheat Codes Featuring Demi Lovato
Lemon - N*E*R*D & Rihanna
When It Rains It Pours - Luke Combs
Portland - Drake Featuring Quavo & Travis Scott
Bad Liar - Selena Gomez
Party - Chris Brown Featuring Usher & Gucci Mane
