See You Again - Wiz Khalifa Featuring Charlie Puth
Hello - Adele
The Hills - The Weeknd
Sorry - Justin Bieber
Cheerleader - OMI
Love Yourself - Justin Bieber
Can't Feel My Face - The Weeknd
Trap Queen - Fetty Wap
Hotline Bling - Drake
What Do You Mean? - Justin Bieber
Sugar - Maroon 5
Watch Me - Silento
Stressed Out - twenty one pilots
Earned It (Fifty Shades Of Grey) - The Weeknd
Stitches - Shawn Mendes
Love Me Like You Do - Ellie Goulding
679 - Fetty Wap Featuring Remy Boyz
Lean On - Major Lazer & DJ Snake Featuring MO
My House - Flo Rida
Want To Want Me - Jason Derulo
Me, Myself & I - G-Eazy x Bebe Rexha
Here - Alessia Cara
Cake By The Ocean - DNCE
Same Old Love - Selena Gomez
Good For You - Selena Gomez Featuring A$AP Rocky
Where Are U Now - Skrillex & Diplo With Justin Bieber
Like I'm Gonna Lose You - Meghan Trainor Featuring John Legend
Fight Song - Rachel Platten
FourFiveSeconds - Rihanna & Kanye West & Paul McCartney
Locked Away - R. City Featuring Adam Levine
Send My Love (To Your New Lover) - Adele
Jumpman - Drake & Future
Hey Mama - David Guetta Featuring Nicki Minaj, Bebe Rexha & Afrojack
Roses - The Chainsmokers Featuring Rozes
Honey, I'm Good. - Andy Grammer
Ex's & Oh's - Elle King
Post To Be - Omarion Featuring Chris Brown & Jhene Aiko
Worth It - Fifth Harmony Featuring Kid Ink
Photograph - Ed Sheeran
My Way - Fetty Wap Featuring Monty
Don't - Bryson Tiller
Somebody - Natalie La Rose Featuring Jeremih
Talking Body - Tove Lo
On My Mind - Ellie Goulding
Hands To Myself - Selena Gomez
One Call Away - Charlie Puth
Drag Me Down - One Direction
Nasty Freestyle - T-Wayne
White Iverson - Post Malone
Antidote - Travis Scott
In The Night - The Weeknd
Take Your Time - Sam Hunt
B**** Better Have My Money - Rihanna
Die A Happy Man - Thomas Rhett
Renegades - X Ambassadors
Cool For The Summer - Demi Lovato
Truffle Butter - Nicki Minaj Featuring Drake & Lil Wayne
One Last Time - Ariana Grande
Hit The Quan - iLoveMemphis
Exchange - Bryson Tiller
Chains - Nick Jonas
You Know You Like It - DJ Snake & AlunaGeorge
Elastic Heart - Sia
Flex (Ooh Ooh Ooh) - Rich Homie Quan
Downtown - Macklemore & Ryan Lewis Featuring Eric Nally, Melle Mel, Kool Moe Dee & Grandmaster Caz
Down In The DM - Yo Gotti Featuring Nicki Minaj
Girl Crush - Little Big Town
Say It - Tory Lanez
Uma Thurman - Fall Out Boy
Lay Me Down - Sam Smith
Slow Motion - Trey Songz
Hide Away - Daya
Again - Fetty Wap
Where Ya At - Future Featuring Drake
When We Were Young - Adele
Focus - Ariana Grande
Ayo - Chris Brown & Tyga
Classic Man - Jidenna Featuring Roman GianArthur
Perfect - One Direction
All Eyes On You - Meek Mill Featuring Chris Brown & Nicki Minaj
Confident - Demi Lovato
Marvin Gaye - Charlie Puth Featuring Meghan Trainor
Blessings - Big Sean Featuring Drake
I Know What You Did Last Summer - Shawn Mendes & Camila Cabello
Break Up In A Small Town - Sam Hunt
Heartbeat Song - Kelly Clarkson
Budapest - George Ezra
House Party - Sam Hunt
Kick The Dust Up - Luke Bryan
Back To Back - Drake
Adventure Of A Lifetime - Coldplay
How Deep Is Your Love - Calvin Harris & Disciples
Burning House - Cam
I Want You To Know - Zedd Featuring Selena Gomez
Strip It Down - Luke Bryan
Throw Sum Mo - Rae Sremmurd Featuring Nicki Minaj & Young Thug
Sangria - Blake Shelton
El Perdon (Forgiveness) - Nicky Jam & Enrique Iglesias
Homegrown - Zac Brown Band
Crash And Burn - Thomas Rhett
