Rockstar - DaBaby Featuring Roddy Ricch
Life Is Good - Future Featuring Drake
WAP - Cardi B Featuring Megan Thee Stallion
Savage - Megan Thee Stallion Featuring Beyonce
Say So - Doja Cat Featuring Nicki Minaj
Dynamite - BTS
Whats Poppin - Jack Harlow Featuring DaBaby, Tory Lanez & Lil Wayne
Toosie Slide - Drake
Intentions - Justin Bieber Featuring Quavo
Roses - SAINt JHN
Laugh Now Cry Later - Drake Featuring Lil Durk
Rain On Me - Lady Gaga & Ariana Grande
I Hope - Gabby Barrett Featuring Charlie Puth
Blueberry Faygo - Lil Mosey
Before You Go - Lewis Capaldi
Stuck With U - Ariana Grande & Justin Bieber
The Scotts - THE SCOTTS, Travis Scott & Kid Cudi
Savage Love (Laxed - Siren Beat) - Jawsh 685 x Jason Derulo
Cardigan - Taylor Swift
Break My Heart - Dua Lipa
Go Crazy - Chris Brown & Young Thug
Come & Go - Juice WRLD x Marshmello
Yummy - Justin Bieber
Trollz - 6ix9ine & Nicki Minaj
Chasin' You - Morgan Wallen
High Fashion - Roddy Ricch Featuring Mustard
Franchise - Travis Scott Featuring Young Thug & M.I.A.
Mood - 24kGoldn Featuring iann dior
Popstar - DJ Khaled Featuring Drake
Death Bed - Powfu Featuring beabadoobee
The Bigger Picture - Lil Baby
Godzilla - Eminem Featuring Juice WRLD
For The Night - Pop Smoke Featuring Lil Baby & DaBaby
We Paid - Lil Baby & 42 Dugg
Sunday Best - Surfaces
Gooba - 6ix9ine
Party Girl - StaySolidRocky
One Margarita - Luke Bryan
Die From A Broken Heart - Maddie & Tae
Wishing Well - Juice WRLD
If The World Was Ending - JP Saxe Featuring Julia Michaels
Hard To Forget - Sam Hunt
Mood Swings - Pop Smoke Featuring Lil Tjay
The Woo - Pop Smoke Featuring 50 Cent & Roddy Ricch
I Hope You're Happy Now - Carly Pearce & Lee Brice
Does To Me - Luke Combs Featuring Eric Church
You Should Be Sad - Halsey
Emotionally Scarred - Lil Baby
Stupid Love - Lady Gaga
Sum 2 Prove - Lil Baby
Got What I Got - Jason Aldean
Dior - Pop Smoke
Supalonely - BENEE Featuring Gus Dapperton
Bluebird - Miranda Lambert
Holy - Justin Bieber Featuring Chance The Rapper
Rags2Riches - Rod Wave Featuring ATR Son Son
One Of Them Girls - Lee Brice
Walk Em Down - NLE Choppa Featuring Roddy Ricch
P*$$y Fairy (OTW) - Jhene Aiko
Be Like That - Kane Brown With Swae Lee & Khalid
Righteous - Juice WRLD
Slide - H.E.R. Featuring YG
The 1 - Taylor Swift
Lovin' On You - Luke Combs
Cool Again - Kane Brown
More Hearts Than Mine - Ingrid Andress
Tap In - Saweetie
Beer Can't Fix - Thomas Rhett Featuring Jon Pardi
Out West - JACKBOYS Featuring Young Thug
Be A Light - Thomas Rhett Featuring Reba McEntire, Hillary Scott, Chris Tomlin & Keith Urban
Be Kind - Marshmello & Halsey
In Your Eyes - The Weeknd
I Love My Country - Florida Georgia Line
After A Few - Travis Denning
What A Man Gotta Do - Jonas Brothers
Girls In The Hood - Megan Thee Stallion
Like That - Doja Cat Featuring Gucci Mane
Greece - DJ Khaled Featuring Drake
Slow Dance In A Parking Lot - Jordan Davis
God Whispered Your Name - Keith Urban
7 Summers - Morgan Wallen
ily - surf mesa Featuring Emilee
Catch - Brett Young
After Party - Don Toliver
ON - BTS
More Than My Hometown - Morgan Wallen
Said Sum - Moneybagg Yo
Lemonade - Internet Money & Gunna Featuring Don Toliver & NAV
My Future - Billie Eilish
Yo Perreo Sola - Bad Bunny
I Love Me - Demi Lovato
Chicago Freestyle - Drake Featuring Giveon
Here And Now - Kenny Chesney
Smile - Juice WRLD & The Weeknd
Homemade - Jake Owen
Exile - Taylor Swift Featuring Bon Iver
Midnight Sky - Miley Cyrus
Believe It - PARTYNEXTDOOR & Rihanna
Baby Pluto - Lil Uzi Vert
One Beer - HARDY Featuring Lauren Alaina & Devin Dawson
