Uptown Funk! - Mark Ronson Featuring Bruno Mars
Happy - Pharrell Williams
All About That Bass - Meghan Trainor
Fancy - Iggy Azalea Featuring Charli XCX
Shake It Off - Taylor Swift
Blank Space - Taylor Swift
Rude - MAGIC!
Thinking Out Loud - Ed Sheeran
Take Me To Church - Hozier
Stay With Me - Sam Smith
Problem - Ariana Grande Featuring Iggy Azalea
Bad Blood - Taylor Swift Featuring Kendrick Lamar
Talk Dirty - Jason Derulo Featuring 2 Chainz
Shut Up And Dance - WALK THE MOON
Bang Bang - Jessie J, Ariana Grande & Nicki Minaj
Am I Wrong - Nico & Vinz
Black Widow - Iggy Azalea Featuring Rita Ora
Animals - Maroon 5
Habits (Stay High) - Tove Lo
Turn Down For What - DJ Snake & Lil Jon
I'm Not The Only One - Sam Smith
Anaconda - Nicki Minaj
Lips Are Movin - Meghan Trainor
Chandelier - Sia
Drunk In Love - Beyonce Featuring Jay Z
Jealous - Nick Jonas
Style - Taylor Swift
Don't Tell 'Em - Jeremih Featuring YG
Maps - Maroon 5
Break Free - Ariana Grande Featuring Zedd
Wiggle - Jason Derulo Featuring Snoop Dogg
Summer - Calvin Harris
G.D.F.R. - Flo Rida Featuring Sage The Gemini & Lookas
Wildest Dreams - Taylor Swift
Latch - Disclosure Featuring Sam Smith
Hot Boy - Bobby Shmurda
Rather Be - Clean Bandit Featuring Jess Glynne
Love Me Harder - Ariana Grande & The Weeknd
Don't - Ed Sheeran
Boom Clap - Charli XCX
Loyal - Chris Brown Featuring Lil Wayne & French Montana Or Too $hort Or Tyga
Centuries - Fall Out Boy
Not A Bad Thing - Justin Timberlake
Time Of Our Lives - Pitbull & Ne-Yo
I Don't F**k With You - Big Sean Featuring E-40
Bailando - Enrique Iglesias Featuring Descemer Bueno & Gente de Zona
Ain't It Fun - Paramore
Only - Nicki Minaj Featuring Drake, Lil Wayne & Chris Brown
The Heart Wants What It Wants - Selena Gomez
I Don't Mind - Usher Featuring Juicy J
Riptide - Vance Joy
Trumpets - Jason Derulo
No Type - Rae Sremmurd
Sing - Ed Sheeran
Tuesday - I LOVE MAKONNEN Featuring Drake
Waves - Mr. Probz
Classic - MKTO
Cool Kids - Echosmith
Lifestyle - Rich Gang Featuring Young Thug & Rich Homie Quan
Na Na - Trey Songz
Play It Again - Luke Bryan
7/11 - Beyonce
Burnin' It Down - Jason Aldean
A Sky Full Of Stars - Coldplay
Blame - Calvin Harris Featuring John Newman
Love Runs Out - OneRepublic
Dirt - Florida Georgia Line
Bottoms Up - Brantley Gilbert
Me And My Broken Heart - Rixton
Dear Future Husband - Meghan Trainor
The Hanging Tree - James Newton Howard Featuring Jennifer Lawrence
Shower - Becky G
2 On - Tinashe Featuring ScHoolboy Q
CoCo - O.T. Genasis
New Flame - Chris Brown Featuring Usher & Rick Ross
Love Never Felt So Good - Michael Jackson & Justin Timberlake
American Kids - Kenny Chesney
Birthday - Katy Perry
La La La - Naughty Boy Featuring Sam Smith
Ghost - Ella Henderson
Can't Remember To Forget You - Shakira Featuring Rihanna
She Knows - Ne-Yo Featuring Juicy J
Drunk On A Plane - Dierks Bentley
Partition - Beyonce
Beachin' - Jake Owen
Bartender - Lady Antebellum
Amnesia - 5 Seconds Of Summer
Something In The Water - Carrie Underwood
Steal My Girl - One Direction
Stolen Dance - Milky Chance
Believe Me - Lil Wayne Featuring Drake
Come With Me Now - KONGOS
Prayer In C - Lillywood & Robin Schulz
Leave The Night On - Sam Hunt
Night Changes - One Direction
0 To 100 / The Catch Up - Drake
She Looks So Perfect - 5 Seconds Of Summer
Fireball - Pitbull Featuring John Ryan
Neon Lights - Demi Lovato
Paranoid - Ty Dolla $ign Featuring B.o.B
