Closer - The Chainsmokers Featuring Halsey
One Dance - Drake Featuring WizKid & Kyla
Work - Rihanna Featuring Drake
That's What I Like - Bruno Mars
Black Beatles - Rae Sremmurd Featuring Gucci Mane
Bad And Boujee - Migos Featuring Lil Uzi Vert
Cheap Thrills - Sia Featuring Sean Paul
Starboy - The Weeknd Featuring Daft Punk
Panda - Desiigner
Can't Stop The Feeling! - Justin Timberlake
Heathens - twenty one pilots
Don't Let Me Down - The Chainsmokers Featuring Daya
7 Years - Lukas Graham
Cold Water - Major Lazer Featuring Justin Bieber & MO
This Is What You Came For - Calvin Harris Featuring Rihanna
24K Magic - Bruno Mars
Let Me Love You - DJ Snake Featuring Justin Bieber
I Don't Wanna Live Forever (Fifty Shades Darker) - Zayn / Taylor Swift
Pillowtalk - Zayn
Work From Home - Fifth Harmony Featuring Ty Dolla $ign
I Took A Pill In Ibiza - Mike Posner
Side To Side - Ariana Grande Featuring Nicki Minaj
Needed Me - Rihanna
Ride - twenty one pilots
Broccoli - D.R.A.M. Featuring Lil Yachty
Congratulations - Post Malone Featuring Quavo
Treat You Better - Shawn Mendes
Don't Wanna Know - Maroon 5 Featuring Kendrick Lamar
Say You Won't Let Go - James Arthur
Bad Things - Machine Gun Kelly x Camila Cabello
Juju On That Beat (TZ Anthem) - Zay Hilfigerrr & Zayion McCall
Scars To Your Beautiful - Alessia Cara
I Feel It Coming - The Weeknd Featuring Daft Punk
Fake Love - Drake
Love On The Brain - Rihanna
No - Meghan Trainor
I Hate U I Love U - gnash Featuring Olivia O'Brien
Bounce Back - Big Sean
Redbone - Childish Gambino
Just Like Fire - P!nk
Dangerous Woman - Ariana Grande
Caroline - Amine
Starving - Hailee Steinfeld & Grey Featuring Zedd
Don't Mind - Kent Jones
Too Good - Drake Featuring Rihanna
Rockabye - Clean Bandit Featuring Sean Paul & Anne-Marie
We Don't Talk Anymore - Charlie Puth Featuring Selena Gomez
Never Forget You - Zara Larsson & MNEK
Low Life - Future Featuring The Weeknd
Mercy - Shawn Mendes
Gold - Kiiara
Controlla - Drake
H.O.L.Y. - Florida Georgia Line
Unsteady - X Ambassadors
Into You - Ariana Grande
Let It Go - James Bay
For Free - DJ Khaled Featuring Drake
The Greatest - Sia Featuring Kendrick Lamar
2 Phones - Kevin Gates
Oui - Jeremih
Me Too - Meghan Trainor
Sucker For Pain - Lil Wayne, Wiz Khalifa & Imagine Dragons With Logic & Ty Dolla $ign Feat. X Ambassadors
All Time Low - Jon Bellion
Close - Nick Jonas Featuring Tove Lo
Never Be Like You - Flume Featuring Kai
Luv - Tory Lanez
OOOUUU - Young M.A
Million Reasons - Lady Gaga
Sorry - Beyonce
Goosebumps - Travis Scott
Chill Bill - Rob $tone Featuring J. Davi$ & Spooks
In The Name Of Love - Martin Garrix & Bebe Rexha
Hymn For The Weekend - Coldplay
Blue Ain't Your Color - Keith Urban
This Town - Niall Horan
Lost Boy - Ruth B
Middle - DJ Snake Featuring Bipolar Sunshine
Sit Still, Look Pretty - Daya
Pop Style - Drake Featuring The Throne
Tiimmy Turner - Desiigner
Summer Sixteen - Drake
Back To Sleep - Chris Brown
Deja Vu - J. Cole
Love Me Now - John Legend
All In My Head (Flex) - Fifth Harmony Featuring Fetty Wap
X - 21 Savage & Metro Boomin Featuring Future
All The Way Up - Fat Joe, Remy Ma & Jay Z Featuring French Montana & Infared
Setting The World On Fire - Kenny Chesney Featuring P!nk
No Limit - Usher Featuring Young Thug
You Was Right - Lil Uzi Vert
May We All - Florida Georgia Line Featuring Tim McGraw
Cut It - O.T. Genasis Featuring Young Dolph
Really Really - Kevin Gates
Humble And Kind - Tim McGraw
Better Man - Little Big Town
Dirt On My Boots - Jon Pardi
Party Monster - The Weeknd
You Should Be Here - Cole Swindell
Used To This - Future Featuring Drake
The Fighter - Keith Urban Featuring Carrie Underwood
