Somebody That I Used To Know - Gotye Featuring Kimbra
Call Me Maybe - Carly Rae Jepsen
One More Night - Maroon 5
Thrift Shop - Macklemore & Ryan Lewis Featuring Wanz
Locked Out Of Heaven - Bruno Mars
Diamonds - Rihanna
Payphone - Maroon 5 Featuring Wiz Khalifa
We Are Never Ever Getting Back Together - Taylor Swift
Radioactive - Imagine Dragons
Some Nights - fun.
When I Was Your Man - Bruno Mars
Whistle - Flo Rida
Ho Hey - The Lumineers
Gangnam Style - PSY
I Knew You Were Trouble. - Taylor Swift
Glad You Came - The Wanted
Cruise - Florida Georgia Line Featuring Nelly
Wide Awake - Katy Perry
Die Young - Ke$ha
Starships - Nicki Minaj
Wild Ones - Flo Rida Featuring Sia
What Makes You Beautiful - One Direction
Scream & Shout - will.i.am & Britney Spears
Part Of Me - Katy Perry
Home - Phillip Phillips
As Long As You Love Me - Justin Bieber Featuring Big Sean
Boyfriend - Justin Bieber
Blow Me (One Last Kiss) - P!nk
Too Close - Alex Clare
Don't You Worry Child - Swedish House Mafia Featuring John Martin
Beauty And A Beat - Justin Bieber Featuring Nicki Minaj
Everybody Talks - Neon Trees
Drive By - Train
Good Time - Owl City & Carly Rae Jepsen
I Cry - Flo Rida
Let Me Love You (Until You Learn To Love Yourself) - Ne-Yo
Girl On Fire - Alicia Keys Featuring Nicki Minaj
It's Time - Imagine Dragons
Mercy - Kanye West, Big Sean, Pusha T, 2 Chainz
I Won't Give Up - Jason Mraz
Scream - Usher
Daylight - Maroon 5
Wanted - Hunter Hayes
Feel So Close - Calvin Harris
I Will Wait - Mumford & Sons
Don't Wake Me Up - Chris Brown
F**kin Problems - A$AP Rocky Featuring Drake, 2 Chainz & Kendrick Lamar
Try - P!nk
Give Your Heart A Break - Demi Lovato
Sweet Nothing - Calvin Harris Featuring Florence Welch
Little Talks - Of Monsters And Men
Adorn - Miguel
Clique - Kanye West, Jay-Z, Big Sean
The A Team - Ed Sheeran
Swimming Pools (Drank) - Kendrick Lamar
Want U Back - Cher Lloyd
Back In Time - Pitbull
Springsteen - Eric Church
Brokenhearted - Karmin
Catch My Breath - Kelly Clarkson
No Lie - 2 Chainz Featuring Drake
Blown Away - Carrie Underwood
Let's Go - Calvin Harris Featuring Ne-Yo
Hall Of Fame - The Script Featuring will.i.am
Good Girl - Carrie Underwood
Live While We're Young - One Direction
22 - Taylor Swift
Climax - Usher
So Good - B.o.B
Pontoon - Little Big Town
50 Ways To Say Goodbye - Train
Pound The Alarm - Nicki Minaj
Work Hard, Play Hard - Wiz Khalifa
Thinkin Bout You - Frank Ocean
Don't Stop The Party - Pitbull Featuring TJR
Skyfall - Adele
Come Over - Kenny Chesney
Birthday Cake - Rihanna Featuring Chris Brown
Turn Up The Music - Chris Brown
Drank In My Cup - Kirko Bangz
Take A Little Ride - Jason Aldean
I Will Always Love You - Whitney Houston
Heart Attack - Trey Songz
Better Dig Two - The Band Perry
Bandz A Make Her Dance - Juicy J Featuring Lil Wayne & 2 Chainz
Red - Taylor Swift
We Run The Night - Havana Brown Featuring Pitbull
Poetic Justice - Kendrick Lamar Featuring Drake
Pop That - French Montana Featuring Rick Ross, Drake, Lil Wayne
Va Va Voom - Nicki Minaj
I'm Different - 2 Chainz
Dance Again - Jennifer Lopez Featuring Pitbull
Madness - Muse
Night Train - Jason Aldean
Cashin' Out - Ca$h Out
Hard To Love - Lee Brice
No Worries - Lil Wayne Featuring Detail
Somethin' 'Bout A Truck - Kip Moore
Even If It Breaks Your Heart - Eli Young Band
Faded - Tyga Featuring Lil Wayne
