God's Plan - Drake
Girls Like You - Maroon 5 Featuring Cardi B
In My Feelings - Drake
Without Me - Halsey
Nice For What - Drake
Thank U, Next - Ariana Grande
Sunflower (Spider-Man: Into The Spider-Verse) - Post Malone & Swae Lee
Sicko Mode - Travis Scott
I Like It - Cardi B, Bad Bunny & J Balvin
Psycho - Post Malone Featuring Ty Dolla $ign
Happier - Marshmello & Bastille
Lucid Dreams - Juice WRLD
Better Now - Post Malone
High Hopes - Panic! At The Disco
Finesse - Bruno Mars & Cardi B
The Middle - Zedd, Maren Morris & Grey
Shallow - Lady Gaga & Bradley Cooper
This Is America - Childish Gambino
Sad! - XXXTENTACION
Eastside - benny blanco, Halsey & Khalid
Drip Too Hard - Lil Baby & Gunna
Youngblood - 5 Seconds Of Summer
Boo'd Up - Ella Mai
Look Alive - BlocBoy JB Featuring Drake
FEFE - 6ix9ine Featuring Nicki Minaj & Murda Beatz
ZEZE - Kodak Black Featuring Travis Scott & Offset
No Tears Left To Cry - Ariana Grande
Love Lies - Khalid & Normani
Going Bad - Meek Mill Featuring Drake
Taste - Tyga Featuring Offset
Sweet But Psycho - Ava Max
Yes Indeed - Lil Baby & Drake
Better - Khalid
Mo Bamba - Sheck Wes
Mine - Bazzi
Nonstop - Drake
Pray For Me - The Weeknd & Kendrick Lamar
MIA - Bad Bunny Featuring Drake
Tequila - Dan + Shay
Delicate - Taylor Swift
Wake Up In The Sky - Gucci Mane X Bruno Mars X Kodak Black
Friends - Marshmello & Anne-Marie
Natural - Imagine Dragons
Money - Cardi B
Walk It Talk It - Migos Featuring Drake
Freaky Friday - Lil Dicky Featuring Chris Brown
Stir Fry - Migos
Trip - Ella Mai
God Is A Woman - Ariana Grande
Taki Taki - DJ Snake Featuring Selena Gomez, Ozuna & Cardi B
Breathin - Ariana Grande
All The Stars - Kendrick Lamar & SZA
Back To You - Selena Gomez
No Brainer - DJ Khaled Featuring Justin Bieber, Chance The Rapper & Quavo
Speechless - Dan + Shay
You Say - Lauren Daigle
In My Blood - Shawn Mendes
I Like Me Better - Lauv
Beautiful Crazy - Luke Combs
Plug Walk - Rich The Kid
Look Back At It - A Boogie Wit da Hoodie
Be Careful - Cardi B
Bartier Cardi - Cardi B Featuring 21 Savage
Big Bank - YG Featuring 2 Chainz, Big Sean & Nicki Minaj
Be Alright - Dean Lewis
Beautiful - Bazzi Featuring Camila Cabello
Leave Me Alone - Flipp Dinero
Close To Me - Ellie Goulding X Diplo Featuring Swae Lee
Call Out My Name - The Weeknd
I Love It - Kanye West & Lil Pump
Envy Me - Calboy
Mona Lisa - Lil Wayne Featuring Kendrick Lamar
Killshot - Eminem
I'm Upset - Drake
Uproar - Lil Wayne
When The Party's Over - Billie Eilish
Close Friends - Lil Baby
One Kiss - Calvin Harris & Dua Lipa
Say Something - Justin Timberlake Featuring Chris Stapleton
Broken - lovelytheband
You Make It Easy - Jason Aldean
She Got The Best Of Me - Luke Combs
King's Dead - Jay Rock, Kendrick Lamar, Future & James Blake
Moonlight - XXXTENTACION
Simple - Florida Georgia Line
Te Bote - Casper Magico, Nio Garcia, Darell, Nicky Jam, Ozuna & Bad Bunny
Lucky You - Eminem Featuring Joyner Lucas
Chun-Li - Nicki Minaj
Get Along - Kenny Chesney
I'm A Mess - Bebe Rexha
Apes**t - The Carters
Changes - XXXTENTACION
Mercy - Brett Young
Ring - Cardi B Featuring Kehlani
Outside Today - YoungBoy Never Broke Again
X - Nicky Jam x J Balvin
One Number Away - Luke Combs
Powerglide - Rae Sremmurd & Juicy J
Dura - Daddy Yankee
Best Shot - Jimmie Allen
